0000000000
0011000000
0011111110
0000000001
1000000001
1000000001
1000000001
1000000001
10000P0001
1111111111